21 19
#####################
#P........#........G#
#.######.#.######.#
#.#....#.#.#....#.#
#. . #.#.#. .##. .#
#.#....#...#....#.#
#.######...######.#
#.................#
#.## ###...## ###.
#.#....#...#....#.#
#.#.##.#.#.#.##.#.#
#.#....#.#.#....#.#
#.## ###.#.## ###.#
#........#........#
#.## ###.#.## ###.
#.#....#.#.#....#.#
#.#.##.#.#.#.##.#.#
#.#....#.#.#....#.#
#####################